111111111
1P00000C1
101111101
100C00001
100011101
10B00C001
100000E01
111111111