1111111111111111111111111111111
10000P0000000E000000000000000C1
1111111111111111111111111111111