1111111111
1P000000C1
1111111101
100C000001
1000111111
10000C0001
1000001101
1000000E01
1111111111