11111111111111111111
1P001100000000000001
100010C0000000000001
10111011111111111101
10000000C00000000001
11111011111111111101
1000000C100000000001
10111110111111111101
10100000000000000001
10001111111111111101
1000C000000000000001
10111011111111111101
10000000C00000000001
11111011111111111101
10000000000000000001
11111110111111111101
10000000C00000000001
10001111111111111101
100000000000000E0001
11111111111111111111