1111111111111111111111111
1C0000E0000P0000C000C1011
1C01111111111000C000C0001
1C00CCCCCC0010011110C0001
1C00000C00001000C010C0001
1CC0000000000000000000001
1C00C01000CC0000C001C1001
1CC0000001111001C000C0001
1C000000000010111110C0001
1C00010000001000C010C0011
1111111111111111111111111